HP强化药水	高级材料
MP强化药水	高级材料
八荒	前期装备
霸者之刃	赤月装备
白金项链	垃圾装备
白色虎齿项链	前期装备
半月	前期装备
半月弯刀	高级技能书
爆裂火焰	一般技能书
爆炎剑法	雪域技能书
辟邪手镯	垃圾装备
避魂靴	祖玛装备
冰咆哮	高级技能书
玻璃戒指	垃圾装备
铂金戒指	沃玛装备
铂金手镯	沃玛装备
布鞋	沃玛装备
布衣(男)	垃圾装备
布衣(女)	垃圾装备
裁决之杖	祖玛装备
赤金逍遥扇	雪域装备
传奇道刃	火龙装备
传奇护腕	火龙装备
传奇面巾	火龙装备
传奇魔刃	火龙装备
传奇神甲(男)	火龙装备
传奇神甲(女)	火龙装备
传奇神剑	火龙装备
传奇项链	火龙装备
传奇勋章	火龙装备
传奇腰带	火龙装备
传奇战刃	火龙装备
传奇之冠	火龙装备
传奇之戒	火龙装备
传奇之靴	火龙装备
传送戒指	特殊戒指
传统项链	垃圾装备
刺杀剑术	一般技能书
大火球	一般技能书
大手镯	垃圾装备
道德戒指	前期装备
道士手镯	垃圾装备
道士头盔	垃圾装备
灯笼项链	前期装备
地狱火	一般技能书
地狱雷光	高级技能书
毒蜘蛛牙齿	垃圾材料
短剑	垃圾装备
躲避手链	前期装备
恶魔长袍(男)	沃玛装备
恶魔长袍(女)	沃玛装备
恶魔铃铛	祖玛装备
法神戒指	赤月装备
法神披风	赤月装备
法神手镯	赤月装备
法神头盔	赤月装备
法神纹章	魔龙装备
法神项链	赤月装备
防御戒指	特殊戒指
放大镜	前期装备
凤凰明珠	前期装备
凤天魔甲	魔龙装备
复活戒指	特殊戒指
干肉	垃圾材料
钢盔甲(男)	祖玛装备
钢盔甲(女)	祖玛装备
钢手镯	垃圾装备
钢铁腰带	祖玛装备
攻击力药水	高级材料
攻杀剑术	垃圾技能书
古铜戒指	垃圾装备
骨玉权杖	祖玛装备
光芒道戒	魔龙装备
光芒道袍(男)	魔龙装备
光芒道袍(女)	魔龙装备
光芒道靴	魔龙装备
光芒护腕	魔龙装备
光芒项链	魔龙装备
光芒腰带	魔龙装备
海魂	前期装备
寒冰掌	赤月技能书
黑色水晶戒指	前期装备
黑色水晶项链	垃圾装备
黑檀手镯	垃圾装备
黑檀项链	垃圾装备
黑铁矿石	高级材料
黑铁手套	祖玛装备
黑铁头盔	沃玛装备
黑铁头盔(封印)	高级材料
黑铁头盔(极品)	祖玛装备
虹魔戒指	祖玛装备
虹魔手镯	祖玛装备
虹魔项链	祖玛装备
红宝石戒指	沃玛装备
护身戒指	特殊戒指
护体神盾	魔龙技能书
黄金裁决	雪域装备
黄金头盔	赤月装备
黄色水晶项链	垃圾装备
凰天魔衣	魔龙装备
活力戒指	特殊戒指
火把	垃圾装备
火炬	垃圾装备
火龙气焰	雪域技能书
火墙	一般技能书
火球术	垃圾技能书
火焰戒指	特殊戒指
基本剑术	垃圾技能书
鸡蛋糕	高级材料
鸡肉	垃圾材料
集体隐身术	一般技能书
疾风药水	高级材料
疾光电影	高级技能书
技巧项链	祖玛装备
记忆戒指	沃玛装备
记忆手镯	沃玛装备
记忆头盔	沃玛装备
记忆项链	沃玛装备
坚固手套	前期装备
降魔	前期装备
降妖除魔戒指	前期装备
金创药(小)包	垃圾材料
金创药(小量)	垃圾材料
金创药(中)包	垃圾材料
金创药(中量)	垃圾材料
金戒指	前期装备
金矿	高级材料
金手镯	前期装备
金项链	垃圾装备
精灵头盔	垃圾装备
精神力药水	高级材料
精神力战法	垃圾技能书
井中月	沃玛装备
开天	魔龙装备
开天斩	魔龙技能书
抗拒火环	垃圾技能书
狂风戒指	沃玛装备
狂风项链	祖玛装备
困魔咒	高级技能书
蜡烛	垃圾装备
蓝色水晶戒指	垃圾装备
蓝翡翠项链	前期装备
雷电术	一般技能书
雷霆护腕	魔龙装备
雷霆项链	魔龙装备
雷霆腰带	魔龙装备
雷霆战甲(男)	魔龙装备
雷霆战甲(女)	魔龙装备
雷霆战戒	魔龙装备
雷霆战靴	魔龙装备
力量戒指	祖玛装备
炼狱	沃玛装备
烈火剑法	高级技能书
烈焰护腕	魔龙装备
烈焰魔戒	魔龙装备
烈焰魔靴	魔龙装备
烈焰魔衣(男)	魔龙装备
烈焰魔衣(女)	魔龙装备
烈焰项链	魔龙装备
烈焰腰带	魔龙装备
凌风	前期装备
灵魂火符	一般技能书
灵魂项链	祖玛装备
灵魂战衣(男)	前期装备
灵魂战衣(女)	前期装备
流星火雨	魔龙技能书
六角戒指	垃圾装备
龙骨刀	魔龙装备
龙骨甲(男)	魔龙装备
龙骨甲(女)	魔龙装备
龙骨戒	魔龙装备
龙骨盔	魔龙装备
龙骨链	魔龙装备
龙骨镯	魔龙装备
龙鳞	高级材料
龙纹剑	祖玛装备
龙牙	赤月装备
龙之戒指	沃玛装备
龙之手镯	祖玛装备
鹿皮靴	祖玛装备
鹿茸	高级材料
鹿血	高级材料
绿色项链	祖玛装备
罗刹	前期装备
麻痹戒指	特殊戒指
灭天火	赤月技能书
命运戒指	祖玛装备
命运手镯	祖玛装备
命运项链	祖玛装备
命运之刃	赤月装备
魔法长袍(男)	前期装备
魔法长袍(女)	前期装备
魔法盾	高级技能书
魔法力药水	高级材料
魔法手镯	垃圾装备
魔法头盔	垃圾装备
魔法药(小)包	垃圾材料
魔法药(小量)	垃圾材料
魔法药(中)包	垃圾材料
魔法药(中量)	垃圾材料
魔鬼项链	前期装备
魔力戒指	垃圾装备
魔力手镯	垃圾装备
魔力项链	垃圾装备
魔龙盔	魔龙装备
魔血戒指	祖玛装备
魔血手镯	祖玛装备
魔血项链	祖玛装备
魔杖	沃玛装备
木剑	垃圾装备
霓裳羽衣	赤月装备
凝霜	前期装备
牛角戒指	垃圾装备
怒斩	赤月装备
皮制手套	垃圾装备
苹果	高级材料
破馆珍剑	赤月装备
破魂	前期装备
祈祷戒指	沃玛装备
祈祷手镯	沃玛装备
祈祷头盔	沃玛装备
祈祷项链	沃玛装备
祈祷之刃	沃玛装备
祈福项链	沃玛装备
骑士手镯	祖玛装备
气功波	赤月技能书
强化复活戒指	特殊戒指
强化护身戒指	特殊戒指
强化麻痹戒指	特殊戒指
青铜斧	前期装备
青铜剑	垃圾装备
青铜头盔	垃圾装备
青铜腰带	祖玛装备
轻型盔甲(男)	垃圾装备
轻型盔甲(女)	垃圾装备
求婚戒指	祖玛装备
蛆卵	垃圾材料
群体施毒术	雪域技能书
群体治疗术	高级技能书
荣誉勋章11号	沃玛装备
荣誉勋章12号	沃玛装备
荣誉勋章13号	沃玛装备
荣誉勋章14号	沃玛装备
荣誉勋章15号	沃玛装备
荣誉勋章21号	沃玛装备
荣誉勋章22号	沃玛装备
荣誉勋章23号	沃玛装备
荣誉勋章24号	沃玛装备
荣誉勋章25号	沃玛装备
荣誉勋章31号	沃玛装备
荣誉勋章32号	沃玛装备
荣誉勋章33号	沃玛装备
荣誉勋章34号	沃玛装备
荣誉勋章35号	沃玛装备
荣誉勋章41号	沃玛装备
荣誉勋章42号	沃玛装备
荣誉勋章43号	沃玛装备
荣誉勋章44号	沃玛装备
荣誉勋章45号	沃玛装备
荣誉勋章51号	沃玛装备
荣誉勋章52号	沃玛装备
荣誉勋章53号	沃玛装备
荣誉勋章54号	沃玛装备
荣誉勋章55号	沃玛装备
肉	垃圾材料
三眼手镯	祖玛装备
珊瑚戒指	沃玛装备
蛇眼戒指	前期装备
神秘戒指	垃圾装备
神秘头盔	垃圾装备
神秘腰带	垃圾装备
神圣战甲术	一般技能书
生命项链	沃玛装备
生铁戒指	垃圾装备
圣龙盔	魔龙装备
圣龙魔袍(男)	赤月装备
圣龙魔袍(女)	赤月装备
圣魔戒指	魔龙装备
圣魔手镯	魔龙装备
圣魔项链	魔龙装备
圣言术	高级技能书
圣战宝甲	赤月装备
圣战戒指	沃玛装备
圣战手镯	沃玛装备
圣战头盔	赤月装备
圣战纹章	魔龙装备
圣战项链	赤月装备
狮子吼	赤月技能书
施毒术	垃圾技能书
食人树的果实	垃圾材料
食人树叶	垃圾材料
嗜魂法杖	赤月装备
兽皮腰带	沃玛装备
瞬息移动	一般技能书
思贝儿手镯	沃玛装备
死神手套	前期装备
泰坦戒指	沃玛装备
泰坦战衣(男)	赤月装备
泰坦战衣(女)	赤月装备
探测项链	祖玛装备
天龙盔	魔龙装备
天魔神甲	赤月装备
天师长袍	赤月装备
天珠项链	沃玛装备
天尊道袍	赤月装备
天尊戒指	赤月装备
天尊手镯	赤月装备
天尊头盔	赤月装备
天尊纹章	魔龙装备
天尊项链	赤月装备
铁剑	垃圾装备
铁矿	垃圾材料
铁手镯	垃圾装备
铁腰带	祖玛装备
铜矿	垃圾材料
屠龙	赤月装备
王者道戒	雪域装备
王者道盔	雪域装备
王者道袍(男)	雪域装备
王者道袍(女)	雪域装备
王者道靴	雪域装备
王者斗笠(道)	雪域装备
王者斗笠(法)	雪域装备
王者斗笠(战)	雪域装备
王者法冠	雪域装备
王者法靴	雪域装备
王者护腕(道)	雪域装备
王者护腕(法)	雪域装备
王者护腕(战)	雪域装备
王者魔戒	雪域装备
王者魔衣(男)	雪域装备
王者魔衣(女)	雪域装备
王者圣衣(男)	雪域装备
王者圣衣(女)	雪域装备
王者项链(道)	雪域装备
王者项链(法)	雪域装备
王者项链(战)	雪域装备
王者勋章(道)	雪域装备
王者勋章(法)	雪域装备
王者勋章(战)	雪域装备
王者腰带(道)	雪域装备
王者腰带(法)	雪域装备
王者腰带(战)	雪域装备
王者战戒	雪域装备
王者战盔	雪域装备
王者战靴	雪域装备
王者之剑	雪域装备
王者之刃	雪域装备
王者之杖	雪域装备
沃玛号角	高级材料
乌木剑	垃圾装备
无极棍	沃玛装备
无极真气	赤月技能书
无字天书	高级材料
夏普儿手镯	垃圾装备
小手镯	垃圾装备
蝎子的尾巴	垃圾材料
心灵启示	一般技能书
心灵手镯	祖玛装备
星王道剑	雪域装备
星王道戒	雪域装备
星王道盔	雪域装备
星王道袍(男)	雪域装备
星王道袍(女)	雪域装备
星王道靴	雪域装备
星王法冠	雪域装备
星王法靴	雪域装备
星王护腕(道)	雪域装备
星王护腕(法)	雪域装备
星王护腕(战)	雪域装备
星王魔剑	雪域装备
星王魔戒	雪域装备
星王魔衣(男)	雪域装备
星王魔衣(女)	雪域装备
星王圣剑	雪域装备
星王项链(道)	雪域装备
星王项链(法)	雪域装备
星王项链(战)	雪域装备
星王腰带(道)	雪域装备
星王腰带(法)	雪域装备
星王腰带(战)	雪域装备
星王战甲(男)	雪域装备
星王战甲(女)	雪域装备
星王战戒	雪域装备
星王战靴	雪域装备
修罗	前期装备
玄天	魔龙装备
血饮	赤月装备
阎罗手套	祖玛装备
野蛮冲撞	高级技能书
银矿	垃圾材料
银蛇	沃玛装备
银手镯	垃圾装备
银星勋章(道)	魔龙装备
银星勋章(法)	魔龙装备
银星勋章(战)	魔龙装备
隐身戒指	特殊戒指
隐身术	一般技能书
幽灵盾	一般技能书
幽灵手套	沃玛装备
幽灵项链	沃玛装备
幽灵战衣(男)	沃玛装备
幽灵战衣(女)	沃玛装备
诱惑之光	一般技能书
斩马刀	前期装备
战神戒指	魔龙装备
战神盔甲(男)	沃玛装备
战神盔甲(女)	沃玛装备
战神手镯	魔龙装备
战神项链	魔龙装备
召唤神兽	高级技能书
召唤月灵	雪域技能书
召唤骷髅	一般技能书
珍珠戒指	前期装备
真魂戒指	魔龙装备
真魂手镯	魔龙装备
真魂项链	魔龙装备
镇魂盔	雪域装备
镇龙盔	雪域装备
镇魔盔	雪域装备
镇天	魔龙装备
治愈术	垃圾技能书
中型盔甲(男)	垃圾装备
中型盔甲(女)	垃圾装备
重盔甲(男)	前期装备
重盔甲(女)	前期装备
竹笛	前期装备
主宰护腕	火龙装备
主宰面巾	火龙装备
主宰神甲(男)	火龙装备
主宰神甲(女)	火龙装备
主宰神剑	火龙装备
主宰项链	火龙装备
主宰勋章	火龙装备
主宰腰带	火龙装备
主宰之冠	火龙装备
主宰之戒	火龙装备
主宰之靴	火龙装备
紫碧螺	祖玛装备
紫绸靴	祖玛装备
紫金嗜魂法杖	雪域装备
祖玛头像	高级材料
匕首	垃圾装备
偃月	前期装备
逍遥扇	赤月装备
琥珀项链	垃圾装备
飓风破	魔龙技能书
骷髅戒指	前期装备
骷髅头盔	前期装备
魅力戒指	前期装备
